$,	PU
$.	PU
$(	PU
ADJ	ADJ
ADJA	ADJ
ADJD	ADJ
ADV	ADV
APPO	AP
APPR	AP
APPRART	AP
APZR	AP
ART	AUX
CARD	CARD
FM	FM
ITJ	AUX
KOKOM	KO
KON	KO
KOUI	KO
KOUS	KO
NE	NE
NN	NN
PAV	ADV
PDAT	P
PDS	P
PIAT	P
PIS	P
PPER	P
PPOSAT	P
PPOSS	P
PRELAT	P
PRELS	P
PRF	P
PTKA	AUX
PTKANT	AUX
PTKNEG	AUX
PTKVZ	AUX
PTKZU	AUX
PWAT	P
PWAV	P
PWS	P
TRUNC	TRUNC
VAFIN	VA
VAIMP	VA
VAINF	VA
VAPP	VA
VMFIN	VM
VMINF	VM
VMPP	VM
VVFIN	VV
VVIMP	VV
VVINF	VV
VVIZU	VV
VVPP	VV
XY	AUX
