-	PUN
ABR	ABR
ADJ	ADJ
ADV	ADV
DET:ART	DET
DET:POS	DET
INT	INT
KON	KON
NAM	NAM
NOM	NOM
NUM	NUM
PRO	PRO
PRO:DEM	PRO
PRO:IND	PRO
PRO:PER	PRO
PRO:POS	PRO
PRO:REL	PRO
PRP	PRP
PRP:det	PRP
PUN	PUN
PUN:cit	PUN
SENT	PUN
SYM	SYM
VER:cond	VER
VER:futu	VER
VER:impe	VER
VER:impf	VER
VER:infi	VER
VER:pper	VER
VER:ppre	VER
VER:pres	VER
VER:simp	VER
VER:subi	VER
VER:subp	VER
